21
10
2
#####################
#                   #
#      @            #
#                   #
#################o###
#                *  #
#        o          #
#   1         2     #
#                   #
#####################
